100
13
0
417
300
0000000000000000000000000000000000000000000000000000000000000000000000000000000000000000000000000000
0000000000000000000000000000000000000000000000000000000000000000000000000000000000000000000000000000
0000000000000000000000000000000000000000000011110000000000000000000000000000000000000000000000000000
0011110000000000000011110000000000000000000000000000001100000000000000000000000000000000111111000000
0000000000000000000000011100000011000000000000000000000000000000000000000000000000000000000000000000
0000000000000000000000000000000011000000000000000000000000111111000000000000000000000000000000000000
0000000000000110000000000000000000000000011110000000000000000000000000000001111100000000000011000000
0000000000000110000000000000000000000000011110000000000000000000000000000001111100000000000011000000
0000000000000000000000000000000000000000000000000000000000000000000000000000000000000000000000000000
0000000000000000000000000000000000000000000000000000000000000000000000000000000000000000000000000000
0000100000000000011000000000000000000000000000000000000011111000000000000000000000000100000020000000
1110111111111111111111111111111111111111111111111111111111111111111111111111111111111111111111111111
1110111111111111111111111111111111111111111111111111111111111111111111111111111111111111111111111111
0
