100
13
0
417
100
0000000000000000000000000000000000000000000000000000000000000000000000000000000000000000000000000000
0000000000000000000000000000000000000000000000000000000000000000000000000000000000000000000000000000
0000000000000000000000000000000000000000000011110000000000000000000000000000000000000000000000000000
0011110000000000000011110000000000000000000000000000001100000000000000000000000000000000111111000000
0000000000000000000000011100000011000000000000000000000000000000000000000000000000000000000000000000
0000000000000000000000000000000011000000000000000000000000111111000000000000000000000000000000000000
0000000000000110000000000000000000000000011110000000000000000000000000000001111100000000000011000000
0000010000000110000000000000000000000000011110000000000000000000000000000001111100000000000011000000
0000000000000000000000000000000000000000000000000000000000000000000000000000000000000000000000000000
0010000000000000000000000000000000000000000000000000000000000000000000000000000000000000000000000000
0000100000000000011000000000000000000000000000000000000011111000000000000000000000000100000000000020
1111111110111111111111111111111111111111111111111111111111111111111111111111111111111111111111111111
1111111110111111111111111111111111111111111111111111111111111111111111111111111111111111111111111111
2
14
10
465
0
3
10
62
1
